###|#.#|#$#|#@#|###
##########|#   #.$ @#|#  .# $  #|#  .#    #|## ### ###|#  $ #   #|#        #|#    #   #|#    #   #|##########
    ####|#####  #|#   $  #|# *.#  #|## ## ##|#      #|# @#   #|#  #####|####
 #####| #   ##|##.#$ ##|# $    #|#. .#$ #|### @ ##|  # # #|  #   #|  #####
 #####  | #   ## |## * .##|# $$*  #|#  * . #|## @ ###| #####  
  ####  |###  ###|#   *$ #|# #  # #|#   ** #|###  #@#|  # ** #|  #  # #|  # *. #|  #  ###|  ####  
######  |#    #  |# ##$###|# . *  #|##  * +#| #  $  #| # #*###| #   #  | #####  
    ####  |#####  ## |# .@.$. # |# # $   # |# ##$#### |#   $  ## |### .   ##|  ###    #|    ##   #|     #####
    #### |  ###  # |  #    # |###  # # |# *$ **##|# # +#  #|#  #    #|##    ###| ######  
  ######|###    #|#  *##.#|# #.  .#|# $ $  #|##$#$#@#| #    .#| #######
  #### |###  # |# .* ##|# #   #|#@**  #|# #   #|# $* ##|###  # |  #### 
  ####   |###  ####|# $     #|# . *#  #|###.@#$##|# . *#  #|# $     #|######  #|     ####
 ####     | #  ######| #       #|## # #.$ #|#  * ## ##|# ** # @# |###   * # |  ####  # |     #### 
   #####|####   #|#      #|#  ##.##|## #@  #| #..$  #|## #$###|#   $ # |# #   # |#   ### |#####   
  #####  |###   #  |#   # ## |#  **+ # |## * $*##| # # #  #| #      #| ###  ###|   ####  
####  ####|#  ####  #|#        #|#  ####  #|##@##. $##|#  #.$* # |#      ## |#  #  ##  |#######  
 ####### |##  #  ##|# .$*$. #|#   #   #|##  *  ##| #@ *  # | #######  
 ####### |##  #  ##|#  **$. #|#   #   #|##  *  ##| #  * @# | ####### 
 #### | #  # | #. ##| #$@ #|## * #|#  * #|#  * #|## * #| #  ##| ####
 ###### | #  @ ##|## #   #|# .*.*.#|#  $ $ #|#####$ #|    #  #|    ####
 ####### |##  @  ##|#  ###  #|# # . # #|# #$. $ #|# $   ###|###$. #  |  # . #  |  #####  
  #####  |  #+ .###|  #     #|  ## $  #| ###$####|## $   # |#  . * # |#   #  # |######## 
 #####    | #   #    |##*# #####|# * $ *  #|#   . @  #|###  #*###|  ##   #  |   #####  
  #####   | ##   #   |##  #.##  |# @ $  #  |# * *  ###|##*#*#   #| #       #| ##  #####|  ####    
#####     |#   ##### |# #   $ ##|#.$.$..@ #|#### #$  #|   #   ###|   #####  
   ####  | ### @## |##   * ##|#  ##*  #|#    *  #|##  #$# #| #   .  #| #  #####| #### 
#####    |#   #### |#    $ # |## ##* ##|#  #..  #|#    $$ #|#  #@.###|#######  
##### ####|#   # #  #|#  $###@ #|## $  $  #| # ....$ #| ##  #  ##|  #######    
    #####|#####   #|#       #|#  ..# ##|##$# *  #| # +#*  #| #$ $  ##| #  #### | ####   
 #######  | #  #  ###| #$   $  #| # .#**  #|## #@ # ##|#  ..#. # |# $   $ # |######  # |     ####  
 ####   | # @##  |## . ###|# $$$. #|#..$.# #|# $ $  #|## .  ##| ###### 
 #######| #     #| # .$. #|##$. $##|#  *  # |# $.$## |##@. #  | #####  
 #####  | #   ## |##* ..##|#   #  #|# *    #|# * # ##|##  $$# | ### @# |   #### 
  #######| ##  #  #|##   $$ #|#  #.#  #|#  .+. ##|#  #.#$##|## $  $ #| ####   #|    #####
#####    |#   ###  |#     #  |## #. ###|#@***$* #|#       #|#  #  ###|#######  
  ####  | ##  ###|## ..  #|#  *   #|# $$ ###|## *.#  | # $ #  | # * #  | # @##  | ####   
   ##### | ###   # |##   #@##|# . *$. #|# # $   #|# #$#$###|#  .. #  |#######  
   #### |####  # |# . * # |#@# * # |#   * ##|##$**  #| #     #| ###  ##|   #### 
 ####     | #  ####  | #   * ## |## #  $.##|#  #$.#  #|#  $  $@ #|#  #..#  #|##########
  #####  |  #   #  |### . ## |#  *$* ##|# # * * #|#    * @#|###  ####|  ####  
  ####  |  #  #  |  #* #  |###  ###|# .*   #|# #$ # #|#  @** #|##   ###| #  ##  | #### 
   #####| ###   #|##     #|# *** ##|#  *@ # |# .*$## |##   #  | ##  #  |  ####   